wwwwwwwwwwwwwwwwwwwwww
w        w    w      w
w           www      w
w             w     ww
w           G        w
w   w                w
w    www          w  w
w      wwwwwww  www  w
w              ww    w
w  G            w    w
w  ww  G           G w
wA    wwwwww         w
wwwwwwwwwwwwwwwwwwwwww